.........................................................................................................................................................................................P..........P.......#......P.........P.........#........P..........P........#...P........P.........P....#.....P.........P.........P...............P.........................................................................................................................................................................................................................................................................................................................................................................................................................................................................
.....................................................................................................................................................................................#########################################################################################################################################################################......................................................................................................................................................................................................................................................................................................................................................................................................................................................
....................................................................................................................................................................................#0000000000000000000000000000000000000000000000000000000000000000000000000000000000000000000000000000000000000000000000000000000000000000000000000000000000000000000000000#.....................................................................................................................................................................................................................................................................................................................................................................................................................................................
...................................................................................................................................................................................#000000000000000000000000000000000000000000000000000000000000000000000000000000000000000000000000000000000000000000000000000000000000000000000000000000000000000000000000000#....................................................................................................................................................................................................................................................................................................................................................................................................................................................
..................................................................................................................................................................................#00000000000000000000000000000000000000000000000000000000000000000000000000000000000000000000000000000000000000000000000000000000000000000000000000000000000000000000000000000#...................................................................................................................................................................................................................................................................................................................................................................................................................................................
.................................................................................................................................................................................#0000000000000000000000000000000000000000000000000000000000000000000000000000000000000000000000000000000000000000000000000000000000000000000000000000000000000000000000000000000#..................................................................................................................................................................................................................................................................................................................................................................................................................................................
................................................................................................................................................................................#000000000000000000000000000000000000000000000000000000000000000000000000000000000000000000000000000000000000000000000000000000000000000000000000000000000000000000000000000000000#.................................................................................................................................................................................................................................................................................................................................................................................................................................................
.....................................................................P.....#.....P......P.#.........P..........................................................................#00000000000000000000000000000000000000000000000000000000000000000000000000000000000000000000000000000000000000000000000000000000000000000000000000000000000000000000000000000000000#................................................................................................................................................................................................................................................................................................................................................................................................................................................
................................................................##########################################....................................................................#0000000000000000000000000000000000000000000000000000000000000000000000000000000000000000000000000000000000000000000000000000000000000000000000000000000000000000000000000000000000000#...............................................................................................................................................................................................................................................................................................................................................................................................................................................
...............................................................#000000000000000000000000000000000000000000#..................................................................#000000000000000000000000000000000000000000000000000000000000000000000000000000000000000000000000000000000000000000000000000000000000000000000000000000000000000000000000000000000000000#.................................................................................................................................................P.........#.........P....#......P....#........#....P...#.........P..............#......P............P..........#........P....................................................................................................................................................................
..............................................................#00000000000000000000000000000000000000000000#................................................................#00000000000000000000000000000000000000000000000000000000000000000000000000000000000000000000000000000000000000000000000000000000000000000000000000000000000000000000000000000000000000000#.............................................................................................................................................###################################################################################################################################################.............................................................................................................................................
.............................................................#0000000000000000000000000000000000000000000000#..............................................................#0000000000000000000000000000000000000000000000000000000000000000000000000000000000000000000000000000000000000000000000000000000000000000000000000000000000000000000000000000000000000000000#...........................................................................................................................................#000000000000000000000000000000000000000000000000000000000000000000000000000000000000000000000000000000000000000000000000000000000000000000000000000#............................................................................................................................................
...........P........P...........P............P..............#000000000000000000000000000000000000000000000000#.......P........#....P.......P..#......P.......#......P.....#000000000000000000000000000000000000000000000000000000000000000000000000000000000000000000000000000000000000000000000000000000000000000000000000000000000000000000000000000000000000000000000#........P...........P.#.................P..........#..........P..........P........#.........P..............#.........P.......#...........#00000000000000000000000000000000000000000000000000000000000000000000000000000000000000000000000000000000000000000000000000000000000000000000000000000#...........P...............P........#............P.........#........P................#......P.................P..................P......#..
############################################################00000000000000000000000000000000000000000000000000############################################################00000000000000000000000000000000000000000000000000000000000000000000000000000000000000000000000000000000000000000000000000000000000000000000000000000000000000000000000000000000000000000000000###########################################################################################################################################################################################################################################################################################################################################################################################################################################