....................................................................................................................................................................................................................................................................................................................................................................................................................................................................................................................................................................................................................................................................................................................................................................................................................
....................................................................................................................................................................................................................................................................................................................................................................................................................................................................................................................................................................................................................................................................................................................................................................................................................
....................................................................................................................................................................................................................................................................................................................................................................................................................................................................................................................................................................................................................................................................................................................................................................................................................
....................................................................................................................................................................................................................................................................................................................................................................................................................................................................................................................................................................................................................................................................................................................................................................................................................
....................................................................................................................................................................................................................................................................................................................................................................................................................................................................................................................................................................................................................................................................................................................................................................................................................
....................................................................................................................................................................................................................................................................................................................................................................................................................................................................................................................................................................................................................................................................................................................................................................................................................
............................................................................................................................................................................................................C..........................C............................C...........................T...........................T.........................C.............................................................................................................................................................................................................................................................................................................................................................................................................................................................
.....................................................................................................................................................................................#########################################################################################################################################################################......................................................................................................................................................................................................................................................................................................................................................................................................................................................
....................................................................................................................................................................................#0000000000000000000000000000000000000000000000000000000000000000000000000000000000000000000000000000000000000000000000000000000000000000000000000000000000000000000000000#.....................................................................................................................................................................................................................................................................................................................................................................................................................................................
...................................................................................................................................................................................#000000000000000000000000000000000000000000000000000000000000000000000000000000000000000000000000000000000000000000000000000000000000000000000000000000000000000000000000000#....................................................................................................................................................................................................................................................................................................................................................................................................................................................
..................................................................................................................................................................................#00000000000000000000000000000000000000000000000000000000000000000000000000000000000000000000000000000000000000000000000000000000000000000000000000000000000000000000000000000#...................................................................................................................................................................................................................................................................................................................................................................................................................................................
.................................................................................................................................................................................#0000000000000000000000000000000000000000000000000000000000000000000000000000000000000000000000000000000000000000000000000000000000000000000000000000000000000000000000000000000#..................................................................................................................................................................................................................................................................................................................................................................................................................................................
................................................................................................................................................................................#000000000000000000000000000000000000000000000000000000000000000000000000000000000000000000000000000000000000000000000000000000000000000000000000000000000000000000000000000000000#.................................................................................................................................................................................................................................................................................................................................................................................................................................................
...........................................................................C..............C....................................................................................#00000000000000000000000000000000000000000000000000000000000000000000000000000000000000000000000000000000000000000000000000000000000000000000000000000000000000000000000000000000000#................................................................................................................................................................................................................................................................................................................................................................................................................................................
................................................................##########################################....................................................................#0000000000000000000000000000000000000000000000000000000000000000000000000000000000000000000000000000000000000000000000000000000000000000000000000000000000000000000000000000000000000#...............................................................................................................................................................................................................................................................................................................................................................................................................................................
...............................................................#000000000000000000000000000000000000000000#..................................................................#000000000000000000000000000000000000000000000000000000000000000000000000000000000000000000000000000000000000000000000000000000000000000000000000000000000000000000000000000000000000000#...........................................................................................................................................................R..............C...........T........T........C........................R..............................R.............................................................................................................................................................................
..............................................................#00000000000000000000000000000000000000000000#................................................................#00000000000000000000000000000000000000000000000000000000000000000000000000000000000000000000000000000000000000000000000000000000000000000000000000000000000000000000000000000000000000000#.............................................................................................................................................###################################################################################################################################################.............................................................................................................................................
.............................................................#0000000000000000000000000000000000000000000000#..............................................................#0000000000000000000000000000000000000000000000000000000000000000000000000000000000000000000000000000000000000000000000000000000000000000000000000000000000000000000000000000000000000000000#...........................................................................................................................................#000000000000000000000000000000000000000000000000000000000000000000000000000000000000000000000000000000000000000000000000000000000000000000000000000#............................................................................................................................................
..P.........................................................#000000000000000000000000000000000000000000000000#................C...............T..............T............#000000000000000000000000000000000000000000000000000000000000000000000000000000000000000000000000000000000000000000000000000000000000000000000000000000000000000000000000000000000000000000000#......................T............................R..............................R........................T.................R...........#00000000000000000000000000000000000000000000000000000000000000000000000000000000000000000000000000000000000000000000000000000000000000000000000000000#....................................C......................T.........................R..................................................E..
############################################################00000000000000000000000000000000000000000000000000############################################################00000000000000000000000000000000000000000000000000000000000000000000000000000000000000000000000000000000000000000000000000000000000000000000000000000000000000000000000000000000000000000000000###########################################################################################################################################################################################################################################################################################################################################################################################################################################